NO ./images/wall1.xpm42
SO ./images/wall2.xpm42
WE ./images/wall1.xpm42
EA ./images/wall2.xpm42

CT ./images/ceiling2.xpm42
FT ./images/dirtycarpet2.xpm42

        1111811111111111111111111
        1000000000110000000000001
        1011000001110000000000001
        1001000000000000000000001
111118111011000001110000000000001
100000000011000001110111811111111
11110111111111011100000010001
11110111111111011101010000001
11000000110101011100000080001
10000000000000001800000020001
10000000000000001101010010001
11000001810101011111011110N0111
11110111 1110101 101111010001
11118111 1111111 111111111111