NO ./images/wall1.xpm42
SO ./images/wall2.xpm42
WE ./images/wall1.xpm42
EA ./images/wall2.xpm42

FT ./images/dirtycarpet2.xpm42
CT ./images/ceiling2.xpm42

1111111111111111111181111
1000000000000000000000001
1011111111111111111111101
10111     100010011111008
1000111811100020011000011
8000000000000010W1101111
1111111811211111110081
      1100011 1000011
       111011 108111
         10111101
         10000001
         11181111