NO ./images/wall1.xpm42
SO ./images/wall2.xpm42
WE ./images/wall1.xpm42
EA ./images/wall2.xpm42

FT ./images/dirtycarpet2.xpm42
CT ./images/ceiling2.xpm42

        1111111111111111111111111111111118111111111111111111111111111111111111111111111111111111111111
        1000000000110000000000000000000000000000000000000000000000000000000000000000000000000000000001
        1011000001110000000000000000000000000000000000000000000000000000000000000000000000000000000001
        1001000000000000000000000000000000000000000000000000000000000000000000000000000000000000000001
111111111018000001110000000000000000000000000000000000000000000000000000000000000000000000000000000001
100000000000000000100000000011111111111111181111111111111111000000000000000000000000000111111111111111
10000000000000000001000000001111111111111111111111111111111100000000000000000000000000011
10000000000000000000100000001111111111111111111111111111111100000000000000000000000000011
10000000000000001111110000001111111111111111111111111111111100000000000000000000000000011
10000000000000001111118010001111111111111111111111111111111100000000000000000000000000011
10000000000000001101011100001111111111111111111111111111111800000000000000000000000000011
11000001110101011111011110N00000000000000000000000000000000000000000000000000000000000011
11110111 1110101 101111010000000000000000000000000000000000000000000000000000000111111111
11111111 1111111 111111111111111111118111111111111111111111111111111111111111111111111111