111111
1E0001
100C01
1P0F01
111111