1111111111111111
1E000000000F0001
100F0F0000000C01
10000000P0000F01
1111111111111111