1111111111111
1E000000F0001
100F0F0000C01
100000P000F01
1111111111111