111111111
1E0001001
100C01F01
1P0F01001
111111111