111111111111111111
1E0001100001100001
100F00000C00000CF1
1P0C011000F1100F01
111111111111111111